Roll No.,Name,Physics,Chemistry,Maths/Bio,Eng,CS,Total
11227544,RISHABH,85,82,46,74,49,336
11227545,ROSHAN ,94,91,45,91,66,387
11227546,SAHIL ,95,90,89,86,84,444
11227547,SAUMYA,74,86,52,80,55,347
11227548,SAMANTHA ,64,65,27,56,33,245
11227549,SHIVANI ,79,73,33,72,43,300
11227550,SHOBIT ,62,69,61,52,39,283
11227551,SURAJ ,95,97,98,96,97,483
11227552,YOGESH ,72,72,40,57,33,274
11227553,YUNESH ,57,63,49,70,33,272
